"filename", "language", "Python", "comment", "blank", "total"
"/home/sbhat/Desktop/inv-orca/__init__.py", "Python", 0, 0, 1, 1
"/home/sbhat/Desktop/inv-orca/policy/__init__.py", "Python", 0, 0, 1, 1
"/home/sbhat/Desktop/inv-orca/policy/invorca.py", "Python", 39, 0, 13, 52
"/home/sbhat/Desktop/inv-orca/policy/orca.py", "Python", 35, 9, 12, 56
"/home/sbhat/Desktop/inv-orca/policy/policy.py", "Python", 11, 3, 7, 21
"/home/sbhat/Desktop/inv-orca/policy/utils/GetVelocity.py", "Python", 152, 113, 39, 304
"/home/sbhat/Desktop/inv-orca/policy/utils/OverlapDetection.py", "Python", 136, 6, 33, 175
"/home/sbhat/Desktop/inv-orca/policy/utils/__init__.py", "Python", 0, 0, 1, 1
"/home/sbhat/Desktop/inv-orca/run_comparison.py", "Python", 19, 0, 8, 27
"/home/sbhat/Desktop/inv-orca/run_influence_tests.py", "Python", 25, 0, 6, 31
"/home/sbhat/Desktop/inv-orca/run_overlap_tests.py", "Python", 16, 0, 6, 22
"/home/sbhat/Desktop/inv-orca/run_render_test.py", "Python", 5, 0, 4, 9
"/home/sbhat/Desktop/inv-orca/run_sim.py", "Python", 53, 4, 10, 67
"/home/sbhat/Desktop/inv-orca/sim/__init__.py", "Python", 5, 0, 2, 7
"/home/sbhat/Desktop/inv-orca/sim/agent.py", "Python", 94, 2, 33, 129
"/home/sbhat/Desktop/inv-orca/sim/env.py", "Python", 149, 26, 37, 212
"/home/sbhat/Desktop/inv-orca/sim/renderer.py", "Python", 79, 9, 25, 113
"/home/sbhat/Desktop/inv-orca/tests/__init__.py", "Python", 0, 0, 1, 1
"/home/sbhat/Desktop/inv-orca/tests/compare_official.py", "Python", 128, 12, 45, 185
"/home/sbhat/Desktop/inv-orca/tests/influence_testing.py", "Python", 162, 22, 51, 235
"/home/sbhat/Desktop/inv-orca/tests/overlap_testing.py", "Python", 185, 29, 46, 260
"/home/sbhat/Desktop/inv-orca/tests/test_renderer.py", "Python", 30, 1, 9, 40
"Total", "-", 1323, 236, 390, 1949